ALB = Alberta
BRO = Brock
UOFC = Calgary
CAR = Carleton
DAL = Dalhousie
GUE = Guelph
LKH = Lakehead
LAV = Laval
LTH = Lethbridge
MAN = Manitoba
MCG = McGill
MCM = McMaster
MUN = Memorial
MNC = Moncton
UDM = Montreal
UNB - University of New Brunswick
OTT = Ottawa
QUN = Queen's
UOFR = Regina
UOFS = Saskatchewan
SHR = Sherbrooke
STFX = St. Francis Xavier
SMU = St. Mary's
TOR = Toronto
TWU = Trinity Western
UQTR = Trois-Rivieres
UVIC = Victoria
WAT = Waterloo
UWO = Western
WND = Windsor
YOR = York
